5 5 25
1 2 4 1 4
0 1 3 2 3
1 2 4 0 5
2 3 4 1 3
5 2 3 0 1