5 5 25
1 2 3 3 1
2 1 3 1 2
1 2 4 0 5
2 3 1 4 0
5 2 3 0 1
