5 5 25
1 2 3 3 1
0 1 3 1 2
0 2 0 4 5
2 3 1 4 5
5 2 3 0 1
